Task ID,Priority,Start Time,End Time,Duration,Orbit,Orbit Length,Init Start Time,Init End Time
0,2,33,46,13,44,10,30,49
1,6,97,101,4,17,13,57,119
2,2,51,57,6,24,10,41,59
3,10,76,78,2,25,13,27,114
4,10,67,80,13,40,16,65,114
5,5,65,70,5,18,13,46,116
6,10,97,102,5,6,19,94,107
7,9,75,88,13,38,14,54,95
8,7,79,82,3,30,10,76,85
9,7,70,73,3,42,12,65,79
10,9,108,115,7,37,16,97,116
11,7,71,88,17,36,18,63,95
12,4,62,68,6,48,13,45,94
13,4,53,54,1,10,19,28,69
14,9,70,74,4,24,12,32,87
15,8,76,80,4,39,19,75,81
16,1,72,77,5,37,16,60,119
17,6,14,16,2,17,10,9,21
18,2,49,54,5,10,17,17,76
19,6,64,84,20,46,14,59,97
20,7,79,92,13,31,20,61,108
21,4,92,102,10,5,14,92,116
22,7,49,53,4,6,16,42,77
23,3,60,62,2,36,13,50,91
24,6,100,107,7,28,13,100,107
25,10,66,73,7,26,10,39,107
26,7,37,50,13,39,19,36,51
27,10,104,111,7,1,12,100,120
28,4,76,79,3,5,17,76,79
29,10,60,73,13,11,16,59,120
30,2,79,82,3,43,17,79,84
31,9,49,58,9,20,17,9,65
32,10,54,58,4,5,13,25,120
33,4,67,82,15,2,10,37,87
34,8,56,71,15,2,17,55,74
35,8,25,37,12,30,14,20,40
36,10,70,73,3,18,17,70,74
37,8,47,58,11,22,11,13,77
38,3,45,58,13,15,16,28,66
39,4,54,71,17,9,12,43,89
40,10,58,62,4,3,16,58,62
41,8,72,74,2,29,11,1,86
42,2,88,90,2,4,13,88,90
43,7,79,82,3,17,15,74,118
44,3,94,102,8,3,13,57,104
45,10,82,91,9,21,18,22,93
46,2,17,25,8,32,18,12,36
47,10,22,25,3,2,11,15,53
48,8,71,73,2,23,17,67,73
49,9,35,42,7,24,16,31,44
50,4,79,85,6,50,11,61,107
51,5,44,51,7,26,20,24,94
52,10,71,83,12,48,18,66,94
53,5,7,8,1,18,10,4,86
54,1,29,47,18,25,12,25,87
55,1,27,37,10,5,16,19,61
56,8,91,108,17,38,12,66,110
57,9,73,89,16,13,10,73,90
58,6,72,84,12,21,15,22,115
59,6,76,95,19,48,11,76,95
60,7,46,66,20,1,14,34,112
61,2,89,100,11,13,14,81,116
62,3,4,19,15,6,18,2,27
63,4,44,54,10,36,13,43,54
64,7,77,81,4,16,19,76,82
65,6,76,91,15,3,11,53,97
66,1,106,111,5,18,17,29,116
67,2,116,119,3,22,10,96,119
68,7,93,108,15,38,18,40,116
69,3,48,60,12,15,17,4,60
70,1,95,107,12,36,19,91,107
71,9,104,111,7,11,12,100,114
72,5,33,42,9,25,14,7,70
73,6,99,102,3,24,17,6,108
74,1,42,54,12,24,15,41,70
75,3,26,45,19,37,14,25,45
76,1,75,78,3,9,14,55,94
77,6,78,79,1,45,12,77,80
78,10,22,28,6,1,20,17,67
79,10,100,102,2,27,16,98,103
80,6,58,62,4,48,12,32,98
81,4,70,80,10,16,11,52,83
82,1,52,64,12,45,14,52,73
83,10,42,51,9,48,11,42,53
84,10,79,91,12,30,18,64,96
85,8,78,79,1,33,19,78,79
86,1,30,34,4,33,17,23,106
87,8,19,28,9,11,18,15,120
88,10,36,56,20,32,20,26,60
89,6,19,21,2,40,19,17,22
90,3,40,45,5,11,18,39,50
91,10,39,59,20,43,13,33,59
92,3,89,99,10,19,20,89,99
93,3,56,65,9,21,12,42,92
94,7,80,87,7,47,15,78,108
95,5,54,62,8,1,10,36,107
96,8,66,68,2,48,15,17,86
97,2,90,107,17,44,19,58,116
98,1,43,56,13,6,18,33,70
99,4,58,74,16,45,18,8,89
100,7,43,60,17,25,18,21,81
101,7,41,54,13,22,12,9,73
102,3,74,79,5,37,13,73,87
103,2,21,23,2,19,15,18,23
104,2,77,78,1,35,11,51,106
105,6,96,105,9,1,10,95,106
106,4,70,83,13,10,14,60,83
107,8,92,102,10,38,17,85,114
108,7,56,61,5,39,15,54,62
109,9,77,93,16,4,15,67,105
110,9,105,113,8,12,18,96,115
111,3,65,83,18,38,18,38,105
112,6,102,115,13,7,12,93,116
113,1,51,55,4,19,16,48,60
114,9,76,83,7,6,20,75,84
115,1,79,90,11,27,17,70,105
116,7,36,47,11,25,19,1,61
117,5,90,99,9,5,12,88,99
118,3,72,79,7,46,10,19,88
119,1,28,44,16,39,17,25,47
120,6,63,82,19,30,13,56,117
121,2,38,52,14,38,12,36,58
122,1,60,75,15,46,13,42,87
123,7,25,31,6,35,14,14,34
124,2,74,76,2,38,17,71,79
125,10,21,26,5,18,18,14,28
126,1,55,62,7,16,17,33,118
127,3,48,51,3,34,18,16,87
128,10,44,53,9,17,18,13,60
129,10,90,103,13,6,19,68,112
130,4,38,45,7,13,18,38,50
131,5,60,68,8,21,20,51,79
132,8,44,61,17,37,13,15,95
133,8,4,8,4,4,10,4,10
134,7,65,70,5,17,18,41,114
135,8,97,112,15,3,12,97,117
136,5,48,51,3,7,14,37,117
137,7,82,83,1,44,11,74,84
138,3,84,93,9,48,10,84,93
139,4,48,56,8,26,12,37,81
140,3,64,79,15,15,16,64,79
141,5,57,67,10,44,10,57,67
142,4,26,41,15,37,13,23,58
143,6,69,86,17,43,15,43,114
144,1,70,73,3,43,17,58,82
145,3,66,86,20,4,12,42,103
146,5,81,88,7,12,20,69,117
147,5,55,70,15,41,19,55,70
148,4,58,70,12,48,20,52,72
149,8,38,39,1,49,12,37,39
150,6,87,96,9,15,11,43,114
151,10,98,110,12,34,20,68,112
152,4,30,36,6,47,18,30,41
153,6,32,45,13,43,19,32,45
154,8,50,59,9,18,18,49,59
155,4,64,84,20,22,16,17,107
156,2,80,81,1,49,10,79,92
157,8,84,85,1,41,13,27,101
158,4,91,94,3,47,12,88,96
159,8,53,68,15,6,16,50,91
160,9,91,98,7,14,17,91,104
161,1,97,103,6,36,14,85,108
162,2,111,112,1,47,11,95,117
163,7,65,75,10,24,11,37,90
164,6,23,24,1,5,15,19,49
165,4,50,56,6,34,13,50,68
166,9,43,45,2,11,20,39,45
167,10,75,76,1,26,11,74,76
168,10,101,114,13,23,16,97,116
169,7,87,105,18,17,18,80,108
170,3,27,47,20,27,17,19,52
171,1,25,28,3,18,10,25,28
172,3,77,87,10,27,18,77,88
173,3,18,24,6,33,13,12,39
174,7,85,86,1,13,15,85,89
175,5,39,49,10,6,17,11,56
176,10,41,42,1,18,17,41,42
177,1,71,90,19,7,15,60,91
178,5,54,63,9,46,13,54,76
179,6,87,102,15,27,11,64,114
180,10,108,113,5,19,11,94,120
181,3,60,67,7,41,20,59,69
182,4,63,71,8,31,12,60,85
183,2,52,68,16,40,17,22,99
184,4,85,89,4,32,15,85,97
185,4,27,46,19,22,12,18,47
186,5,78,88,10,38,11,72,114
187,3,33,45,12,22,17,29,51
188,1,10,15,5,31,18,6,17
189,9,37,53,16,26,18,37,114
190,5,60,80,20,13,10,54,81
191,9,51,60,9,33,10,47,105
192,5,45,57,12,4,10,20,89
193,6,43,45,2,14,16,37,45
194,3,23,37,14,1,10,22,45
195,6,57,65,8,31,20,4,105
196,6,99,106,7,49,18,94,106
197,9,21,26,5,49,12,2,85
198,6,51,62,11,21,13,19,98
199,5,104,118,14,11,16,66,119
200,10,53,59,6,37,19,37,84
201,5,94,104,10,14,14,94,104
202,3,89,94,5,11,14,33,120
203,1,62,76,14,14,13,53,95
204,8,84,94,10,43,16,76,103
205,2,95,96,1,38,10,94,96
206,9,66,85,19,21,17,55,92
207,8,98,107,9,2,19,92,112
208,10,41,60,19,27,19,39,65
209,1,66,78,12,26,10,27,92
210,7,31,48,17,14,11,6,85
211,4,65,69,4,8,11,39,100
212,7,79,87,8,30,16,64,92
213,7,19,33,14,14,10,11,40
214,7,77,85,8,46,16,27,86
215,3,74,88,14,30,16,12,105
216,6,81,91,10,7,14,35,97
217,5,59,73,14,39,15,48,91
218,4,27,36,9,26,18,18,41
219,3,76,78,2,19,17,48,104
220,1,76,87,11,35,20,50,117
221,8,54,66,12,35,11,46,92
222,9,52,67,15,15,17,43,109
223,5,36,42,6,5,18,35,46
224,3,86,90,4,28,19,84,91
225,5,77,82,5,14,17,76,106
226,5,71,84,13,48,15,52,96
227,6,94,113,19,6,13,76,120
228,3,87,97,10,43,15,85,113
229,10,70,78,8,1,15,59,108
230,7,61,70,9,28,13,34,97
231,7,32,43,11,22,12,17,72
232,2,93,94,1,3,20,91,95
233,2,31,46,15,27,11,23,86
234,8,88,103,15,27,11,82,108
235,9,34,44,10,44,12,6,57
236,5,27,28,1,39,13,27,28
237,1,97,111,14,3,18,95,111
238,9,77,91,14,44,20,2,101
239,3,16,18,2,6,14,9,51
240,10,99,113,14,33,19,83,115
241,10,94,101,7,36,15,93,107
242,9,11,12,1,5,13,11,76
243,8,79,83,4,28,15,79,88
244,5,77,93,16,46,19,46,111
245,2,65,73,8,10,10,60,76
246,3,105,111,6,1,20,64,112
247,2,96,109,13,8,17,38,115
248,2,70,79,9,40,16,55,118
249,8,95,108,13,45,12,72,118
250,2,8,16,8,17,20,7,19
251,1,100,101,1,1,11,44,108
252,3,37,55,18,10,12,15,100
253,4,94,95,1,32,12,85,100
254,7,75,92,17,11,20,48,115
255,6,76,86,10,16,18,64,88
256,5,64,66,2,7,13,62,66
257,1,31,47,16,32,10,30,106
258,2,32,36,4,23,11,15,64
259,3,61,73,12,47,11,60,101
260,9,75,87,12,16,17,49,91
261,1,94,103,9,19,10,93,109
262,7,51,53,2,15,16,51,53
263,6,97,98,1,26,15,91,99
264,10,81,88,7,50,17,66,117
265,2,48,63,15,45,10,14,102
266,3,74,92,18,17,13,59,113
267,7,22,35,13,27,12,20,43
268,4,70,80,10,35,14,58,83
269,4,47,60,13,44,14,46,67
270,3,25,37,12,14,18,17,91
271,10,83,89,6,26,17,77,103
272,8,47,52,5,3,18,38,55
273,8,85,88,3,38,18,83,88
274,10,82,100,18,44,11,82,105
275,4,50,61,11,10,12,37,94
276,7,12,17,5,49,10,7,75
277,4,62,80,18,13,17,33,113
278,3,58,74,16,20,18,55,96
279,5,64,68,4,8,11,38,68
280,3,66,80,14,2,10,41,82
281,8,69,84,15,49,11,36,118
282,4,27,45,18,18,19,8,85
283,3,80,82,2,32,19,78,85
284,1,28,37,9,29,12,17,64
285,6,87,88,1,25,13,69,88
286,10,100,103,3,42,13,99,103
287,1,91,95,4,34,14,83,101
288,2,89,97,8,47,18,73,104
289,2,109,119,10,12,16,89,120
290,6,86,106,20,41,18,73,116
291,3,90,92,2,2,17,90,95
292,2,48,61,13,42,17,33,71
293,5,70,77,7,8,20,68,94
294,6,18,38,20,13,13,3,38
295,3,56,68,12,16,11,36,76
296,5,18,22,4,19,13,17,56
297,10,14,34,20,11,16,4,93
298,5,45,48,3,35,11,45,48
299,9,69,80,11,49,16,67,111
300,5,58,72,14,21,16,50,88
301,6,20,33,13,13,11,2,49
302,8,94,96,2,9,19,82,108
303,7,76,85,9,31,12,73,95
304,8,29,35,6,28,17,3,63
305,5,78,81,3,25,18,73,83
306,6,97,102,5,34,20,97,104
307,1,64,78,14,34,11,49,88
308,3,102,105,3,41,16,48,109
309,7,93,107,14,37,15,93,109
310,9,47,48,1,44,16,43,49
311,8,37,50,13,38,18,20,68
312,5,54,72,18,16,17,25,112
313,6,63,68,5,16,19,4,88
314,3,60,68,8,25,18,4,107
315,4,42,62,20,47,11,5,65
316,9,100,105,5,17,13,97,112
317,10,37,50,13,22,11,23,60
318,5,77,97,20,5,10,70,98
319,8,56,64,8,29,18,31,76
320,9,70,80,10,26,18,7,91
321,10,81,84,3,26,11,57,86
322,10,66,68,2,17,10,57,71
323,10,71,74,3,7,17,48,90
324,2,59,61,2,9,16,58,68
325,3,99,114,15,36,12,92,120
326,4,47,48,1,22,16,47,48
327,5,100,101,1,23,10,99,101
328,2,49,68,19,10,14,37,119
329,2,84,99,15,21,10,69,111
330,9,90,92,2,23,14,90,99
331,9,78,88,10,15,19,78,89
332,1,99,103,4,43,10,97,110
333,4,38,45,7,43,18,5,66
334,7,90,96,6,3,13,68,115
335,10,90,91,1,9,16,86,105
336,9,61,64,3,15,10,53,66
337,4,44,53,9,38,13,36,53
338,4,43,60,17,34,19,29,112
339,5,65,80,15,31,17,38,84
340,8,37,50,13,19,16,37,50
341,10,95,97,2,6,19,76,97
342,5,97,101,4,28,19,64,101
343,4,85,90,5,2,18,48,96
344,10,101,108,7,7,12,94,110
345,8,31,39,8,20,10,28,62
346,1,21,25,4,32,17,17,42
347,10,37,46,9,3,12,14,62
348,10,85,86,1,30,19,61,97
349,8,55,56,1,35,20,6,90
350,1,55,66,11,14,20,50,83
351,10,30,32,2,1,11,30,32
352,5,69,79,10,50,11,65,81
353,4,83,94,11,32,13,66,104
354,5,71,81,10,6,18,70,110
355,7,29,30,1,31,13,29,35
356,9,66,83,17,40,16,62,106
357,9,95,109,14,38,14,93,110
358,1,71,83,12,5,20,29,117
359,4,63,83,20,13,15,39,102
360,7,71,76,5,39,17,60,78
361,2,70,83,13,34,15,52,113
362,9,67,79,12,38,18,29,99
363,6,94,111,17,48,20,89,116
364,5,59,70,11,41,10,23,98
365,6,84,98,14,24,17,77,100
366,5,26,28,2,18,19,26,28
367,7,68,69,1,33,12,68,70
368,2,98,100,2,40,17,95,101
369,4,91,108,17,47,10,76,114
370,6,68,88,20,36,12,43,119
371,7,28,37,9,17,17,21,51
372,7,49,53,4,33,20,41,58
373,3,87,96,9,43,10,81,102
374,2,90,92,2,38,17,44,116
375,6,97,101,4,9,20,97,102
376,1,79,95,16,11,15,69,97
377,7,60,69,9,23,12,59,75
378,5,58,62,4,1,15,38,98
379,8,17,24,7,24,14,16,24
380,10,68,70,2,37,20,56,71
381,3,94,106,12,11,17,80,118
382,9,81,91,10,5,15,76,108
383,9,97,112,15,30,12,77,113
384,5,50,68,18,36,13,47,73
385,1,44,61,17,36,14,20,86
386,2,33,45,12,29,10,9,64
387,1,67,83,16,29,13,53,114
388,9,54,61,7,33,14,32,79
389,6,102,108,6,46,19,88,109
390,1,38,39,1,45,14,34,39
391,2,56,73,17,32,17,16,109
392,1,78,79,1,46,19,78,79
393,6,38,40,2,6,18,38,45
394,1,99,108,9,3,14,93,109
395,7,59,74,15,46,18,34,81
396,9,92,106,14,17,12,90,111
397,2,22,28,6,42,14,3,65
398,4,58,63,5,39,18,51,66
399,5,90,100,10,34,13,40,106
400,8,19,20,1,20,18,18,26
401,5,42,55,13,20,15,2,95
402,8,87,88,1,39,18,84,91
403,4,43,45,2,14,16,41,45
404,10,77,90,13,39,17,61,103
405,10,28,32,4,41,12,22,43
406,4,45,52,7,20,19,31,104
407,4,51,53,2,9,18,43,91
408,2,94,111,17,8,20,93,111
409,8,22,37,15,27,14,1,37
410,9,41,56,15,16,10,39,86
411,4,63,80,17,7,14,39,114
412,6,43,45,2,12,19,20,60
413,9,99,108,9,34,18,93,115
414,8,93,101,8,48,18,73,117
415,10,84,102,18,48,18,71,113
416,10,75,76,1,36,12,75,76
417,4,103,110,7,9,10,23,112
418,7,30,31,1,23,11,27,94
419,3,102,116,14,24,15,100,116
420,9,44,63,19,40,19,44,107
421,6,99,109,10,26,15,23,116
422,3,17,36,19,17,11,4,63
423,10,17,19,2,2,11,17,32
424,9,100,112,12,44,12,99,112
425,5,61,80,19,16,10,11,82
426,2,32,41,9,32,15,28,101
427,5,62,64,2,30,13,59,65
428,3,25,34,9,41,12,4,73
429,6,3,18,15,19,16,3,18
430,2,98,105,7,22,19,96,117
431,5,103,112,9,15,16,97,112
432,9,71,84,13,40,15,61,92
433,7,40,58,18,43,20,26,81
434,10,91,105,14,47,17,82,112
435,1,103,109,6,24,11,85,115
436,10,59,73,14,5,17,58,90
437,10,53,62,9,24,16,41,68
438,1,63,66,3,38,17,60,68
439,7,45,52,7,19,20,4,83
440,7,111,112,1,43,12,95,114
441,8,66,71,5,44,18,9,99
442,9,103,114,11,8,13,98,114
443,8,35,36,1,43,16,35,36
444,8,27,36,9,11,16,18,64
445,9,69,73,4,18,15,66,74
446,8,74,75,1,36,15,74,108
447,3,53,58,5,18,17,30,90
448,4,86,103,17,28,20,75,103
449,6,68,84,16,33,15,10,112
450,3,75,81,6,24,19,69,87
451,4,64,84,20,36,11,51,115
452,1,100,102,2,6,10,49,111
453,1,92,93,1,4,11,92,94
454,8,57,76,19,50,16,52,76
455,5,67,70,3,3,10,34,106
456,7,49,56,7,32,11,33,65
457,8,27,45,18,38,11,25,56
458,4,37,47,10,19,20,22,64
459,10,83,87,4,36,10,27,92
460,6,80,100,20,47,19,39,119
461,7,40,57,17,37,14,22,57
462,7,98,100,2,45,20,96,100
463,6,91,107,16,40,17,72,114
464,1,78,84,6,25,12,77,98
465,2,28,43,15,2,15,12,95
466,6,20,21,1,46,20,20,22
467,2,29,48,19,24,20,23,85
468,8,87,97,10,47,20,85,108
469,5,20,37,17,20,17,18,43
470,1,76,78,2,37,11,31,84
471,4,97,99,2,26,11,97,100
472,4,80,89,9,6,11,64,90
473,4,46,47,1,20,11,6,65
474,7,70,85,15,12,16,44,113
475,1,63,76,13,7,15,59,115
476,2,51,60,9,31,13,31,60
477,4,88,99,11,24,13,54,120
478,3,99,105,6,43,13,17,108
479,6,81,88,7,39,16,78,90
480,8,101,103,2,16,12,97,118
481,5,75,87,12,30,16,67,90
482,10,102,109,7,26,10,86,110
483,2,29,40,11,22,20,29,45
484,1,24,41,17,47,11,15,46
485,7,75,83,8,47,19,75,85
486,9,54,71,17,17,11,4,108
487,3,37,40,3,10,12,23,68
488,8,38,43,5,29,16,33,108
489,8,53,63,10,24,15,33,80
490,8,49,53,4,10,19,44,55
491,4,45,50,5,27,19,32,116
492,4,97,102,5,2,19,42,109
493,3,8,9,1,23,13,7,11
494,2,59,68,9,49,17,26,70
495,2,69,70,1,20,18,2,108
496,7,60,75,15,5,14,41,120
497,5,49,56,7,24,10,44,59
498,8,51,64,13,50,18,44,68
499,7,95,99,4,5,14,90,117
